111111111111111
100000000000001
100011101110001
10N01 101 10001
100011101110001
100000000000001
101110111011101
101 101 101 101
111 111 111 111
