NO textures/mini_floor.png
SO textures/mini_player.png
WE textures/mini_wall.png
EA textures/zoo.png

F 0,0,0
C 0,0,255

111111111111111
100000100000001
100000000000001
100000000000001
100000000000001
100000N00000001
100000100000001
100000100000001
101111110111111
1011   101
1011  1001
101111001
10000001
11111111