NO textures/mini_floor.png
SO textures/mini_player.png
WE textures/mini_wall.png
EA textures/zoo.png

F 0,0,0
C 0,0,255

111111111111111
100000010000001
100000000000001
100000000000001
1000000N0000001
100000000000001
100000100000001
100000100000001
111111111111111
