1111111
110W001
1100001
1000001
1111111

