NO textures/seamlessbluepink.png
WE textures/seamlesspinkblue.png
SO textures/seamlessneon.png
EA textures/seamlesspink.png

F 136,49,215
C 228,67,173

111111111111111 1111  111
10000010000000110000110001
100000000000000001100001001
100000000000001100111100001
100000000000001 100000011001
100000N0000000111101011 11001
100000100000000000001     101
10000010000000110111     1001
1011111101111110001111111001
1011   10000000010000000001
1011  10011111111111111111
101111001
10000001
11111111