NO textures/image.png
SO textures/crushed.png
WE textures/mini_wall.png
EA textures/moon.png

F 0,0,0
C 10,19,46

111111111111111
100000100000001
100000000000001
100000000000111
100000001000001
100000000010001
100000100000001
1000001000000E1
101111110111111
1011   101
1011  1001
101111001
10000001
11111111